> . . . . . C F
. X X X X X X X
^ . < X v . . <
X X ^ . . < X ^
> . v . < ^ < C
. . . . . X X .
^ X . X ^ X X .
S > > . C > . ^